11111111111111111111111111111
12222222222222222222222222221
12000000000000000000000000021
12000000000000000000000000021
12000000000000000000000000021
12000000000000000000000000021
12000000000000000000000000021
12000000000000000000000000021
12000000000000000000000000021
12000000000000000000000000021
12000000000000000000000000021
12000000000000000000000000021
12000000000000000000000000021
11211111111111101111111111211
12000000000000000000000000021
12000000000000000000000000021
12000000000000000000000000021
12000000000000000000000000021
12000000000000000000000000021
12000000000000000000000000021
12000000000000000000000000021
12000000000000000000000000021
12000000000000000000000000021
12000000000000000000000000021
12000000000000000000000000021
12222222222222222222222222221
11111111111111111111111111111