11111111111111111111111111111
10012121212121212121212121001
10000000000000000000000000001
10012121212121212121212121001
10000000000000000000000000001
10012121212121212121212121001
10000000000000000000000000001
10012121212121212121212121001
10000000000000000000000000001
10012121212121212121212121001
10000000000000000000000000001
10012121212121212121212121001
10000000000000000000000000001
10012121212121202121212121001
10000000000000000000000000001
10012121212121212121212121001
10000000000000000000000000001
10012121212121212121212121001
10000000000000000000000000001
10012121212121212121212121001
10000000000000000000000000001
10012121212121212121212121001
10000000000000000000000000001
10012121212121212121212121001
10000000000000000000000000001
10012121212121212121212121001
11111111111111111111111111111