11111111111111111111111111111
10000000000000000000000000001
10011111111111101111111111201
10111111111111101111111111101
10111111111111101111111111101
10111111111111101111111111101
10111111111111101111111111101
10111111111111101111111111101
10111111111111101111111111101
10111111111111101111111111101
10111111111111101111111111101
10111111111111101111111111101
10111111111111101111111111101
10222222222222222222222222201
10111111111111101111111111101
10111111111111101111111111101
10111111111111101111111111101
10111111111111101111111111101
10111111111111101111111111101
10111111111111101111111111101
10111111111111101111111111101
10111111111111101111111111101
10111111111111101111111111101
10111111111111101111111111101
10211111111111101111111111201
10000000000000000000000000001
11111111111111111111111111111